infatuation - zadurzenie
evaluate - oceniać
sparse - rzadki, skąpy
chafe - ocierać się
aberration - odchylenie
constitute - tworzyć, składać się na
inconsiderate - bezduszny, nieludzki [It was inconsiderate of you not to call.]
jostle - przepychać się [Spectators jostled for a better view]
word of mouth - gossip spread by spoken communication [The news of their affair was spread by word of mouth.]
meddle in - mieszać się w
vocation - powołanie
convoluted - zawiły
idiosyncrasy - dziwactwo
condescend to do sth - raczyć/zechcieć coś zrobić [Do you think you could condescend to help your sister?]
impair - pogarszać, osłabiać [Boiling the soup will impair its flavour. Radio reception had been impaired by the storm.]
hearing impaired - niesłyszący
adorn - ozdoba
infer - wywnioskować, wnioskować [What can you infer from the high level of radiation in the water?]
agile - zwinny, sprawny
auspicious - obiecujący
foliage - (folidż) liście, listowie
inherently - z natury
hamper - przeszkodzić/adzać, utrudnić [the project was hampered by lack of funds]
thrifty - gospodarny, oszczędny [thrifty in sth]
economical with sht - oszczędnie czymś gospodarować
adjourn - odroczyć, przełożyć, odkładać [session, trial, meeting]
sidle into/out of the room - wślizgnąć się do, wymknąć się z pokoju
pasty (pejsti) - ziemisty, blady
frail - słabowity [person, health]
tentatively - wstępnie [agree, plan, schedule]
carnal - cielesny, zmysłowy [pleasure, desire]
witticsm - dowcipne powiedzienie
cricket - świerszcz
transgression - wykroczenie [against sth]
to stonewall sb - unikać odpowiedzi na czyjeś pytania
laundry list (fig) - długa lista
embellish - ozdobić, upiększać
gauge (gejdż) - zmierzyć
utilize (jutilajz) - wykorzystywać
poignant - przejmujący, wzruszający
she won't budge an inch - ona nie ustąpi ani o włos
quip - dowcipna uwaga
leer - chytre spojrzenie, złe spojrzenie,pożądliwe spojrzenie
leer at smb/sth - łypnąć okiem na kogoś,łypnąć okiem na coś
assault and battery - napad z pobiciem
conspicuous - widoczny, rzucający się w oczy
to be conspicuous for sth - zwracać na siebie uwage czymś
cringe - skulić się, wzdrygnąć się
flimsy - cienki, lekki [clothes]
flimsy - marny [argument, evidence]
supposition - przypuszczenie
superfluous - zbyteczny, zbędny
delegate - przekazać, przekazywać [power, authority, duty]
adjective from fidelity - faithful
converge - zbiegać się, zejść, schodzić się
indemnity against sth [loss, theft, flood] - ubezpieczenie
peril - zagrożenie, niebezpieczeństwo
tremulous [hand, voice, sound] - drżący
conjecture (kondżekczer) - przypuszczenie, domysł
gape at sb/sth - wpatrywać się
exquisite [face] - piękny, cudowny
exquisite - [beauty, charm] niespotykany, wyjątkowy
shrill [tone, cry, whistle] - przenikliwy
listless [person, manner] - apatyczny
listless - [movement] powolny, ospały
wilful [person] - uparty, nieposłuszny
penitence - skrucha, żal
falter/falter out [word, phrase] - wykrztusić
refinement - wytworność, elegancja
languid [person] - powolny, ospały
languid - [style, language] rozwlekły
to be on the wane [popularity] - maleć, zmniejszać się
sallow [complexion, skin, face] - ziemisty
varnish - polakierować
to varnish the truth - starać się ukryć niemiłą prawdę
terse (ters) - [answer, article] krótki, zwięzły
contemporary - współczesny, nowoczesny
provenance - pochodzenie
minced - mielony
debase - [metal, currency, emotion, ideal, word] dewaluować, zdewaulować
to be debased - [views, words] zdewaulować się
to go on a shopping spree (spri) - iść zaszaleć w sklepach
to go on a spending spree - zaszaleć
under the guise of sth - pod pozorem czegoś
in the guise of doing sth - pod pretekstem robienia czegoś
drudgery - harówka
saturated with sth - [soil, ground] mokry, przesiąknięty
saturated with sth - [market] nasycony
artifical preservatives - sztuczne konserwanty
savoury - [snack] nie słodki
pungent - [taste] ostry
pungent - [smell, gas, smoke] ostry, gryzący
acrid - [smoke] gryzący
garnish - przybierać [The chicken was garnished with dill. Pasta garnished with a spring of oregano]
scalding (skolding) - niebiezpiecznie gorące
sizzling - bardzo gorące [in a good way]
tepid - ciepławy, letni [only for liquids]
lukewarm - ciepławy, letni [liquids and meals]
finger food - paluszki, chipsy
obsequious to or towards smb - służalczy w stosunku do kogoś
hoof - kopyto
to come out in favour of sth - publicznie zadeklarować poparcie czegoś
to come out - ogłosić swoją homoseksualność
to bring out - wypuścić nowy produkt [kylie is bringing out her new album]
to fall out with smb - kłócić się
to make up - naprawić przyjaźń po kłótni
to hold out for more/better deal - grać na zwłoke dla zysku, nie iść na kompromis
to sell out of sth - wyprzedać coś
unequivocal - jednoznaczny, nie pozostawiający wątpliwości
enroll for a course/on a course - zapisać się, zapisać się na kurs
enlist smb's support - z sukcesem przekonać kogoś żeby nas wsparł
envisage any problems (enwizydż) - przewidzieć problemy
to be engrossed in sth - być pochłoniętym [engrossed in his book]
to endear smb to sth - sprawić by ktoś nas lubił
to enhance - ulepszyć
plaque - płytka nazębna
touch wood/knock on wood - odpukać
bib - śliniak, śliniaczek
demarcate - wytyczyć [boundary]
demarcate - wyznaczyć [scope, space]
surge - [of joy/tenderness] przypływ
affiliate to/with sth - przyłączyć się
vibrant - tętniący życiem, tryskający energią
intermittently - sporadycznie, nieregularnie
futility - daremność, bezsens
exuberant - rozentuzjazmowany, pełen uniesienia, żywiołowy
ghastly - koszmarny, potworny
to turn puce - poczerwienieć (na twarzy), spurpurowieć
belatedly - poniewczasie [I belatedly realised that]
waif - porzucone, bezdomne dziecko
primrose - pierwiosnek
the primrose path - (idiom) pogoń za przyjemnościami życia
candid - szczery, nieupozowany
candid camera - ukryta kamera
myopic - krótkowzroczny
reciprocity - wzajemność
atrocious - potworny, okropny
stoke - dołożyc, dokładać do (czegoś) [stoke the fire]
stoke - podsycić [enthusiasm, interest, anger]
mollify - ułagodzić, udobruchać [person]
to brook no criticism/disagreement - nie tolerować krytyki/odmiennego zdania
this matter brooks no delay - to sprawa nie cierpiąca zwłoki
ardent - żarliwy, gorliy [admirer, supporter]
forlorn - opuszczony [forlorn person]
forlorn - wymarły, opustoszały [forlorn place, street, building]
odiously - wstrętnie, ohydnie
thyme (taajm) - tymianek
a sibilant sound - syczenie
primeval (prajmiwyl) - prastary
ambience - atmosfera, nastrój
to be marooned - zostać porzuconym, tkwić gdzieś
he has a fish bone stuck in his gullet - ość utkwiła mu w gardle
the words stuck in my gullet - słowa uwięzły mi w gardle
obliterate - zatrzeć, zacierać [trace, print]